A	AH
A(2)	EY
ABORT	AH B AO R T
ARE	AA R
ARE(2)	ER
DO	D UW
E_TWO	IY T UW
FELL	F EH L
FIND	F AY N D
HELLO	HH AH L OW
HELLO(2)	HH EH L OW
HOW	HH AW
JOKE	JH OW K
LAW	L AO
LAW(2)	L AA
PEOPLE	P IY P AH L
SOMETHING	S AH M TH IH NG
TELL	T EH L
THANK	TH AE NG K
YOU	Y UW
