ABORT	AH B AO R T
ARE	AA R
ARE(2)	ER
DO	D UW
E_TWO	IY T UW
FEEL	F IY L
FIND	F AY N D
GO	G OW
HELL	HH EH L
HELLO	HH AH L OW
HELLO(2)	HH EH L OW
HOW	HH AW
JOKE	JH OW K
LAW	L AO
LAW(2)	L AA
NEWS	N UW Z
NEWS(2)	N Y UW Z
PEOPLE	P IY P AH L
TELL	T EH L
THANK	TH AE NG K
YOU	Y UW
